###### ###
###### ###
#####  ###
####  ####
##########